111111111111111111111111
100000000000001000000001
100000000000001000000001
100111111000001000111001
100000000000000000010001
1001111100000P0000010001
100000010000000000010001
100000010000000000011111
100000010000000000000001
100000010000011111000001
100000010000000000000001
111111111111111111111111