NO textures/red.png
SO textures/black.png
WE textures/sky.png
EA textures/green.png
F 22,100,55
C 225,30,0







        1111111111111111111111111
        10000000001100000S0000001
        1011000001110000000000001
        1001000000000000000000001
111111111011000001110000100000001
100000000011000001110111111111111
11110111111111011100000010001
11110111111111011101010010001
11000000110101011100000010001
10000000001010001100000010001
10000000000000001101010010001
1100000111000101111101111000111
11110111 11001010101111010001
11111111 111111111111111111111111111