111111111111111111111111
100000000000000010000001
100000000000000010000001
100000000000000010000001
100000000000000000000001
1000000000000P0000000001
100000000000000010000001
111111111111111111111111