NO textures/red.png
SO textures/black.png
WE textures/sky.png
EA textures/green.png
F 22,100,55
C 22,100,55




        1111111111111111111111111
        1000000000110000010000001
        1011000001110000000000001
        1001000000000000000000001111
111111111011000001110000100000001
100000000011000001110112111111111
11111211111111011100000010001
11110011111110111010100100011
110000000000101011100000010001
10000010001010001100020010001111
1000N0010000000001101010010001
1000000000000101111101111000111
11110111111001010101111010001
11111111 111111111111111111111111111